orthographe	phonetique
aime	Em
musique	myzik
fille	fij
garçon	gaRsM
pizza	piza
chien	SjN
mange	mAZ
manger	mAZe
est	E
tout	tut
et	e
va	va
de	d@
dans	dA
forêt	fORE
ma	ma
avec	avEk
village	vilaZ
ville	vil
mouille	muj
les	lE
j'aime	ZEm
la	la
la	la
le	l@
